XXXXXXXXXXXXXXXXXXXXXXXXXXXXXXXXXXXXXXXXXXXXXXXXXXXXXXXXXXXXXXXXXXXXXXX
P     X   X                 X                 X           X           X
X XXX X X X XXXXXXXXX XXXXX X XXX XXXXXXXXXXX XXXXX XXXXX XXXXX XXXXX X
X X X   X   X X     X X     X   X X   X X   X       X   X     X   X   X
X X XXXXXXXXX X XXX XXX XXXXXXX XXX X X X X XXXXXXXXXXX XXXXX X X XXXXX
X X           X X   X   X     X X   X X   X   X             X X X     X
X XXXXXXX XXX X X XXX X X XXX X X XXX XXX XXX X X XXX XXXXXXX X XXXXX X
X       X X   X X X   X X X     X   X   X   X   X   X X       X X   X X
XXXXXXX XXX XXX X X XXXXX X XXXXXXX XXX XXX XXXXXXX XXX XXXXXXX X X X X
X X   X     X   X   X     X X     X   X X   X     X   X X       X X X X
X X X XXXXX X XXXXX X XXXXXXX XXX XXX X X XXXXX XXXXX X XXXXXXX X XXX X
X X X       X X X   X       X X X X   X X       X   X X X     X   X   X
X X XXXXXXXXX X X XXXXXXXXX X X X X XXX XXXXXXXXX X X X X XXX XXXXX X X
X   X   X     X   X X       X X X     X X         X   X   X X X     X X
X XXX XXX XXXXX XXX X XXXXXXX X XXXXX X X XXXXXXXXXXX XXXXX X X XXXXX X
X X     X   X     X X X     X   X   X X X X         X       X X X   X X
X XXXXX XXX XXXXX X X X XXX XXX X X XXX X X XXXXXXX XXXXXXXXX X X X XXX
X X       X   X X   X   X     X X X     X X       X       X   X   X   X
X X XXXXXXXXX X XXX XXXXX X XXX X XXXXXXX XXX XXXXXXXXXXX X XXXXXXXXX X
X X   X       X         X X X   X X       X   X           X   X     X X
X XXX X XXX XXXXXXXXXXX X XXX XXX X XXXXX X XXX XXX XXXXXXXXX X XXX X X
X     X X   X   X     X X   X X   X     X X   X X   X       X   X   X X
XXXXX X X XXX X X XXX XXXXX X X XXX XXX X XXX X XXXXX XXX X XXXXX XXX X
X   X X X X   X X   X X   X   X X   X   X   X X   X   X   X     X   X X
X XXX X XXX XXX XXX X X X XXXXX XXXXX XXXXX X XXX X XXX XXXXXXXXXXX X X
X X   X     X X   X X X X     X     X   X   X   X   X X           X X X
X X XXXXXXXXX X XXX X X XXX XXXXXXX XXX XXXXXXX XXXXX XXXXXXXXX XXX X X
X X     X     X     X X   X     X   X   X     X X             X     X X
X XXXXX XXXXX XXXXXXX XXX XXXXX X XXX X X XXX X X XXXXXXXXX X XXXXXXX X
X     X     X     X     X   X   X   X X X X   X X X         X   X     X
X X XXXXXXX XXXXX X XXXXXXX X XXXXXXX XXX X XXX XXX XXXXXXXXXXX XXXXX X
X X               X         X             X         X                 K
XXXXXXXXXXXXXXXXXXXXXXXXXXXXXXXXXXXXXXXXXXXXXXXXXXXXXXXXXXXXXXXXXXXXXXX